51 23
211111555555555555555555555555555555555555555111111
111111255551111111111111111111111111111155552111111
555521111255551111111111111111111111155552111125555
522555521111255551111111111111111155552111125555225
522522555521111255551111111111155552111125555225225
555522522555521111255551111155552111125555225225555
511555522522555521111255555552111125555225225555115
511111555522522555521111111111125555225225555111115
511111111555522522555523212325555225225555111111115
511111111111555522522523212325225225555111111111115
511111111111111555522523212325225555111111111111115
511111111111111111522523212325225111111111111111115
511111111111111555522523212325225555111111111111115
511111111111555522522523212325225225555111111111115
511111111555522522555523212325555225225555111111115
511111555522522555521111111111125555225225555111115
511555522522555521111255555552111125555225225555115
555522522555521111255551111155552111125555225225555
522522555521111255551111111111155552111125555225225
522555521111255551111111111111111155552111125555225
555521111255551111111111111111111111155552111125555
111111255551111111111111111111111111111155552111111
111111555555555555555555555555555555555555555111111
